111111111111111
1E0000000010001
111111111010011
100000011010111
100000111001111
100111000001111
101000010001001
100100000000101
100001111110001
100000111111101
 11111       1

 R 1920 1080
 N0 lqksdhjlksqdh/qsdgqhksdg/qdshgqsdk
 E 132 255 256
 S0 sdufpsfupsodfuposf/slkdhflsdhf
