111111111111111
100000000010001
111111111010011
100000011010111
100000111001111
100111000001111
101000010001001
100100000000101
100001111110001
100000111111101
111111111111111
